250	4	12,13,14,15,16,17
251	4	0,1,2,3,4,5
252	4	30,31,32,33,34,35
260	4	18,19,20,21,22,23
261	4	6,7,8,9,10,11
262	4	36,37,38,39,40,41
270	4	24,25,26,27,28,29
272	4	42,43,44,45,46,47