0,0,0,0,0,0,0,0,0,0,0,0,0,0,0,0,0,0,0,0,0,0,0,0,0,0,0,0,0,0,0,0,0,0,0,0,0,0,0,0,0,0,0,0,0,0,0,0,0,0
0,0,0,0,0,0,0,0,0,0,0,0,0,0,0,0,0,0,0,0,0,0,0,0,0,0,0,0,0,0,0,0,0,0,0,0,0,0,0,0,0,0,0,0,0,0,0,0,0,0
0,0,0,0,0,0,0,0,0,0,0,0,0,0,0,0,0,0,0,0,0,0,0,0,0,0,0,0,0,0,0,0,0,0,0,0,0,0,0,0,0,0,0,0,0,0,0,0,0,0
0,0,0,0,0,0,0,0,0,0,0,0,0,0,0,0,0,0,0,0,0,0,0,0,0,0,0,0,0,0,0,0,0,0,0,0,0,0,0,0,0,0,0,0,0,0,0,0,0,0
0,0,0,0,0,0,0,0,0,0,0,0,0,0,0,0,0,0,0,0,0,0,0,0,0,0,0,0,0,0,0,0,0,0,0,0,0,0,0,0,0,0,0,0,0,0,0,0,0,0
0,0,0,0,0,0,0,0,0,0,0,0,0,0,0,0,0,0,0,0,0,0,0,0,0,0,0,0,0,0,0,0,0,0,0,0,0,0,0,0,0,0,0,0,0,0,0,0,0,0
0,0,0,0,0,0,0,0,0,0,0,0,0,0,0,0,0,0,0,0,0,0,0,0,0,0,0,0,0,0,0,0,0,0,0,0,0,0,0,0,0,0,0,0,0,0,0,0,0,0
0,0,0,0,0,0,0,0,0,0,0,0,0,0,0,0,0,0,0,0,0,0,0,0,0,0,0,0,0,0,0,0,0,0,0,0,0,0,0,0,0,0,0,0,0,0,0,0,0,0
0,0,0,0,0,0,0,0,0,0,0,0,0,0,0,0,0,0,0,0,0,0,0,0,0,0,0,0,0,0,0,0,0,0,0,0,0,0,0,0,0,0,0,0,0,0,0,0,0,0
0,0,0,0,0,0,0,0,0,0,0,0,0,0,0,0,0,0,0,0,0,0,0,0,0,0,0,0,0,0,0,0,0,0,0,0,0,0,0,0,0,0,0,0,0,0,0,0,0,0
0,0,0,0,0,0,0,0,0,0,0,0,0,0,0,0,0,0,0,0,0,231,232,233,228,228,232,232,245,0,0,0,0,0,0,0,0,0,0,0,0,0,0,0,0,0,0,0,0,0
0,0,0,0,0,0,0,0,0,0,0,0,0,0,0,0,0,0,0,0,231,233,228,228,238,238,228,228,234,235,0,0,0,0,0,0,0,0,0,0,0,0,0,0,0,0,0,0,0,0
0,0,0,0,0,0,0,0,0,0,0,0,0,0,0,0,0,0,0,0,240,228,228,215,215,215,215,228,228,245,0,0,0,0,0,0,0,0,0,0,0,0,0,0,0,0,0,0,0,0
0,0,0,0,0,0,0,0,0,0,0,0,0,0,0,0,0,0,0,0,234,228,215,215,217,219,215,215,228,234,0,0,0,0,0,0,0,0,0,0,0,0,0,251,252,252,253,0,0,0
0,0,0,0,0,0,0,0,0,0,0,0,0,0,0,0,0,0,0,0,228,228,215,217,228,228,219,215,228,228,0,0,0,0,0,0,0,0,0,0,0,251,252,261,250,250,260,252,253,0
0,0,0,0,0,0,0,0,0,0,0,0,0,0,0,0,0,0,0,0,242,215,215,237,228,228,239,215,215,243,0,0,0,0,0,0,0,0,0,0,0,257,250,250,250,250,250,250,258,0
0,0,0,0,0,0,0,0,0,0,0,0,0,0,0,0,0,0,0,0,240,215,215,215,227,229,215,215,215,245,0,0,0,0,0,0,0,0,0,0,0,257,250,250,250,250,250,250,258,0
0,0,0,0,0,0,0,0,0,0,0,0,0,0,0,0,0,0,0,0,240,215,215,215,227,229,215,215,215,245,0,0,0,0,0,0,0,0,0,0,0,257,250,250,250,250,250,250,258,0
0,0,0,0,0,0,0,0,0,0,0,0,0,0,0,0,0,0,0,0,240,215,215,215,227,229,215,215,215,245,0,0,0,0,0,0,0,0,0,0,0,254,255,255,250,250,255,255,256,0
0,0,0,0,0,0,0,0,0,0,0,0,0,0,0,0,0,0,0,0,241,232,232,242,227,229,243,232,232,244,0,0,0,0,0,0,0,0,0,0,0,264,265,265,254,256,265,265,266,0
0,0,0,0,0,0,0,0,0,0,0,0,0,0,0,0,0,0,0,0,196,206,196,189,212,212,189,196,207,196,0,0,0,0,0,0,0,0,0,0,0,0,0,0,0,0,0,0,0,0
0,0,0,0,0,0,0,0,0,0,0,0,0,0,0,0,0,0,0,0,208,196,196,211,212,212,213,196,207,208,0,0,0,0,0,0,0,0,0,0,0,0,0,0,0,0,0,0,0,0
0,0,0,0,0,0,0,0,0,0,0,0,0,0,0,0,0,0,0,0,207,208,196,211,212,212,213,196,206,207,0,0,0,0,0,0,0,0,0,0,0,0,0,0,0,0,0,0,0,0
0,0,0,0,0,0,0,0,0,0,0,0,0,0,0,0,0,0,0,0,206,206,196,211,212,212,213,196,206,206,0,0,0,0,0,0,0,0,0,0,0,0,0,0,0,0,0,0,0,0
0,0,0,0,0,0,0,0,0,0,0,0,0,0,0,0,0,0,0,0,187,187,187,211,212,212,213,187,187,187,0,0,0,0,0,0,0,0,0,0,0,0,0,0,0,0,0,0,0,0
0,0,0,0,0,0,0,0,0,0,0,0,0,0,0,0,0,0,0,0,188,188,188,211,212,212,213,188,188,188,0,0,0,0,0,0,0,0,0,0,0,0,0,0,0,0,0,0,0,0
0,0,0,0,0,0,0,0,0,0,0,0,0,0,0,0,0,0,0,0,188,188,188,211,212,212,213,188,188,188,0,0,0,0,0,0,0,0,0,0,0,0,0,0,0,0,0,0,0,0
0,0,0,0,0,0,0,0,0,0,0,0,0,0,0,0,0,0,0,0,188,188,188,211,212,212,213,188,188,188,0,0,0,0,0,0,0,0,0,0,0,0,0,0,0,0,0,0,0,0
0,0,0,0,0,0,0,0,0,0,0,0,0,0,0,0,0,0,0,0,188,188,188,211,212,212,213,188,188,188,0,0,0,0,0,0,0,0,0,0,0,0,0,0,0,0,0,0,0,0
0,0,0,0,0,0,0,0,0,0,0,0,0,0,0,0,0,0,0,0,188,188,188,189,212,212,189,188,188,188,0,0,0,0,0,0,0,0,0,0,0,0,0,0,0,0,0,0,0,0
0,0,0,0,0,0,0,0,0,0,113,116,123,115,103,105,123,115,115,105,0,0,0,189,212,212,189,0,0,0,133,134,134,134,134,135,135,135,135,136,0,0,0,0,0,0,0,0,0,0
0,0,0,0,0,0,0,0,0,0,118,114,123,119,126,113,123,116,117,104,0,0,0,211,212,212,213,0,0,0,133,129,129,129,146,147,129,129,129,136,0,0,0,0,0,0,0,0,0,0
0,0,0,0,0,0,0,0,0,0,125,125,125,114,114,117,125,114,113,115,0,11,10,189,212,212,189,10,16,0,133,129,143,144,144,144,144,145,129,136,0,0,0,0,0,0,0,0,0,0
0,0,0,0,0,0,0,0,0,0,85,97,94,94,94,94,94,94,119,83,0,12,2,2,2,2,2,2,15,0,133,129,152,112,112,112,112,153,129,136,0,0,0,0,0,0,0,0,0,0
0,0,0,0,0,0,0,0,0,0,95,97,94,94,94,94,94,94,124,93,0,12,2,2,2,2,2,2,15,0,133,129,152,112,112,112,112,153,129,136,0,0,0,0,0,0,0,0,0,0
0,0,0,0,0,0,0,0,0,0,95,97,94,94,94,94,94,94,124,93,0,12,2,2,2,2,2,2,15,0,133,129,152,112,112,112,112,153,129,136,0,0,0,0,0,0,0,0,0,0
0,0,0,0,0,0,0,0,0,0,95,106,94,94,94,94,94,94,124,93,0,12,2,2,2,2,2,2,15,0,133,129,152,112,112,112,112,153,129,136,0,0,0,0,0,0,0,0,0,0
0,0,0,0,0,0,0,0,0,0,95,97,94,94,94,94,94,94,125,93,0,12,2,2,2,2,2,2,15,0,133,129,152,112,112,112,112,153,129,136,0,0,0,0,0,0,0,0,0,0
0,0,0,0,0,0,0,0,0,0,95,96,88,94,86,88,94,97,124,93,0,12,2,2,2,2,2,2,15,0,133,129,129,129,151,146,129,129,129,136,0,0,0,0,0,0,0,0,0,0
0,0,0,0,0,0,0,0,0,0,84,84,85,94,83,84,84,84,123,84,0,13,6,6,3,6,6,6,14,0,128,137,137,138,146,139,137,137,137,128,0,0,0,0,0,0,0,0,0,0
0,0,0,0,0,0,0,0,0,0,84,84,84,94,84,84,84,84,84,84,0,0,0,0,3,0,0,0,0,0,134,134,134,134,146,135,135,135,135,135,0,0,0,0,0,0,0,0,0,0
0,0,0,0,0,0,0,0,0,0,17,17,17,3,17,17,17,17,17,17,0,0,0,0,3,0,0,0,0,0,8,2,2,2,2,2,2,2,2,9,0,0,0,0,0,0,0,0,0,0
0,11,10,10,10,10,10,10,16,0,11,10,10,3,10,10,10,10,10,16,0,11,10,10,3,10,10,10,16,0,12,2,2,2,2,2,2,2,2,15,0,0,0,0,0,0,0,0,0,0
0,12,2,2,2,2,2,2,15,0,12,2,2,2,2,2,2,2,2,15,0,12,2,2,2,2,2,2,15,0,12,2,2,2,2,2,2,2,2,15,0,0,0,0,0,0,0,0,0,0
0,12,2,2,2,2,2,2,15,0,12,2,2,2,2,2,2,2,2,15,0,12,2,2,2,2,2,2,15,0,12,2,2,2,2,2,2,2,2,15,0,0,0,0,0,0,0,0,0,0
0,12,2,2,2,2,2,2,15,0,12,2,2,2,2,2,2,2,2,15,0,12,2,2,2,2,2,2,15,0,12,2,2,2,2,2,2,2,2,15,0,0,0,0,0,0,0,0,0,0
0,12,2,2,2,2,2,2,3,3,3,2,2,2,2,2,2,2,2,3,3,3,2,2,2,2,2,2,3,3,3,2,2,2,2,2,2,2,2,15,0,0,0,0,0,0,0,0,0,0
0,12,2,2,2,2,2,2,3,3,3,2,2,2,2,2,2,2,2,3,3,3,2,2,2,2,2,2,3,3,3,2,2,2,2,2,2,2,2,15,0,0,0,0,0,0,0,0,0,0
0,12,2,2,2,2,2,2,9,17,8,2,2,2,2,2,2,2,2,9,17,8,2,2,2,2,2,2,9,17,8,2,2,2,2,2,2,2,2,15,0,0,0,0,0,0,0,0,0,0
0,13,6,6,154,154,6,6,14,0,13,6,6,6,6,6,6,6,6,14,0,13,6,6,3,3,6,6,14,0,13,6,6,6,6,6,6,6,6,14,0,0,0,0,0,0,0,0,0,0
190,176,177,185,154,154,183,175,175,191,23,21,21,21,21,21,21,21,21,22,0,0,0,0,3,3,0,0,0,0,64,65,65,65,65,65,65,65,65,64,0,0,0,0,0,0,0,0,0,0
190,160,161,161,161,161,161,161,162,191,23,31,28,29,28,28,29,28,31,22,0,0,0,0,3,3,0,0,0,0,66,63,63,63,76,76,63,63,63,67,0,0,0,0,0,0,0,0,0,0
190,174,171,171,171,171,171,171,173,191,23,28,28,28,28,28,28,28,28,22,0,11,10,10,3,3,10,10,16,0,66,76,76,76,76,76,76,76,76,67,0,0,0,0,0,0,0,0,0,0
190,165,157,171,171,171,171,155,167,191,23,31,28,28,28,28,28,28,31,22,0,12,2,2,2,2,2,2,15,0,66,92,76,76,76,76,76,76,90,67,0,0,0,0,0,0,0,0,0,0
190,165,157,171,171,171,171,155,167,191,23,28,28,28,28,28,28,28,28,22,0,12,2,2,2,2,2,2,15,0,66,102,76,76,76,76,76,76,100,67,0,0,0,0,0,0,0,0,0,0
190,165,157,171,171,171,171,155,167,191,23,28,28,28,28,28,28,28,28,22,0,12,2,2,2,2,2,2,15,0,66,102,76,76,76,76,76,76,100,67,0,0,0,0,0,0,0,0,0,0
190,165,157,171,171,171,171,171,163,191,23,28,28,28,28,28,28,28,28,22,0,12,2,2,2,2,2,2,15,0,66,102,76,76,76,76,76,76,100,67,0,0,0,0,0,0,0,0,0,0
190,164,171,171,171,171,156,156,173,191,23,28,28,28,28,28,28,28,28,22,0,12,2,2,2,2,2,2,15,0,66,102,76,76,76,76,76,76,100,67,0,0,0,0,0,0,0,0,0,0
190,174,166,166,157,155,166,166,166,191,23,28,28,28,28,28,28,28,28,22,0,12,2,2,2,2,2,2,15,0,66,112,91,91,91,91,91,91,112,67,0,0,0,0,0,0,0,0,0,0
190,149,149,149,146,146,149,149,149,191,45,24,24,24,27,28,26,24,24,45,0,13,6,6,3,6,6,6,14,0,64,73,73,73,76,76,73,73,73,64,0,0,0,0,0,0,0,0,0,0
190,146,146,149,146,146,149,146,146,191,21,21,21,21,21,28,21,21,21,21,1,1,1,1,3,1,1,1,1,1,65,65,65,65,76,76,65,65,65,45,51,43,43,43,43,43,43,43,43,50
190,149,149,149,146,146,149,149,149,191,8,2,2,2,2,2,2,2,2,9,1,1,1,1,3,1,1,1,1,1,8,2,2,2,2,2,2,2,2,50,51,32,60,58,33,33,57,62,32,50
190,181,164,146,146,146,146,146,169,191,12,2,2,2,2,2,2,2,2,15,1,11,10,10,3,10,10,10,16,1,12,2,2,2,2,2,120,121,121,50,51,60,58,33,33,33,33,57,61,50
190,179,180,181,181,181,181,164,167,191,12,2,2,2,2,2,2,2,2,15,1,12,2,2,2,2,2,2,15,1,12,2,2,2,2,2,130,33,33,43,43,58,33,33,33,33,33,33,55,50
190,179,179,154,154,154,154,170,167,191,12,2,2,2,2,2,2,2,2,15,1,12,2,2,2,2,2,2,15,1,12,2,2,2,2,2,130,33,33,55,55,55,33,33,33,33,33,55,55,50
190,179,154,154,154,154,154,170,167,191,12,2,2,2,2,2,2,2,2,3,3,3,2,2,2,2,2,2,3,3,3,2,2,2,2,2,130,33,33,55,55,55,33,33,33,33,33,55,55,50
190,179,179,154,154,154,154,170,167,191,12,2,2,2,2,2,2,2,2,3,3,3,2,2,2,2,2,2,3,3,3,2,2,2,2,2,130,33,33,40,41,48,33,33,33,33,33,33,55,50
190,179,154,160,161,161,161,174,167,191,12,2,2,2,2,2,2,2,2,9,17,8,2,2,2,2,2,2,9,17,8,2,2,2,2,2,140,141,141,50,51,80,48,33,33,33,33,47,81,50
190,179,179,170,171,171,169,166,159,191,13,6,6,6,6,6,6,6,6,14,1,12,2,2,2,2,2,2,15,1,13,6,6,6,6,6,6,6,6,50,51,32,80,48,33,33,47,82,32,50
192,193,193,193,193,193,193,193,193,194,1,1,1,1,1,1,1,1,1,1,1,13,6,6,3,3,6,6,14,1,1,1,1,1,1,1,1,1,1,50,44,34,34,34,34,34,34,34,34,44
0,0,0,0,0,0,0,0,0,0,0,0,0,0,0,0,0,0,0,0,1,11,10,10,3,3,10,10,16,1,0,0,0,0,0,0,0,0,0,0,0,0,0,0,0,0,0,0,0,0
0,0,0,0,0,0,0,0,0,0,0,0,0,0,0,0,0,0,0,0,1,12,2,2,2,2,2,2,15,1,0,0,0,0,0,0,0,0,0,0,0,0,0,0,0,0,0,0,0,0
0,0,0,0,0,0,0,0,0,0,0,0,0,0,0,0,0,0,0,0,1,12,2,2,2,2,2,2,15,1,0,0,0,0,0,0,0,0,0,0,0,0,0,0,0,0,0,0,0,0
0,0,0,0,0,0,0,0,0,0,0,0,0,0,0,0,0,0,0,0,1,12,2,2,2,2,2,2,15,1,0,0,0,0,0,0,0,0,0,0,0,0,0,0,0,0,0,0,0,0
0,0,0,0,0,0,0,0,0,0,0,0,0,0,0,0,0,0,0,0,1,12,2,2,2,2,2,2,15,1,0,0,0,0,0,0,0,0,0,0,0,0,0,0,0,0,0,0,0,0
0,0,0,0,0,0,0,0,0,0,0,0,0,0,0,0,0,0,0,0,1,12,2,2,2,2,2,2,15,1,0,0,0,0,0,0,0,0,0,0,0,0,0,0,0,0,0,0,0,0
0,0,0,0,0,0,0,0,0,0,0,0,0,0,0,0,0,0,0,0,1,12,2,2,2,2,2,2,15,1,0,0,0,0,0,0,0,0,0,0,0,0,0,0,0,0,0,0,0,0
0,0,0,0,0,0,0,0,0,0,0,0,0,0,0,0,0,0,0,0,1,13,6,6,6,6,6,6,14,1,0,0,0,0,0,0,0,0,0,0,0,0,0,0,0,0,0,0,0,0
0,0,0,0,0,0,0,0,0,0,0,0,0,0,0,0,0,0,0,0,1,1,1,1,1,1,1,1,1,1,0,0,0,0,0,0,0,0,0,0,0,0,0,0,0,0,0,0,0,0
0,0,0,0,0,0,0,0,0,0,0,0,0,0,0,0,0,0,0,0,1,1,1,1,1,1,1,1,1,1,0,0,0,0,0,0,0,0,0,0,0,0,0,0,0,0,0,0,0,0
